XXXXXXXXXXXXXXXXXXXXXXXXXXXXXXXXXXXXXXXX
X--------------------------------------X
X--------------------------------------X
XXXXXXXXXXXXXXXXXXXXX------------------X
XXXXXXXXXXXXXXXXXXXXXXXXX-----------XXXX
XXXXXXXXXXXXXXXXXXXXXXXXX--------XXXXXXX
X--------------------------------------X
X--------------------------------------X
X--------------------------------------X
X--------------------------------------X
X--------------------------XXXX--------X
X--------------------------------------X
X--------------------------------------X
X--------------------------------------X
X----XXXXXXXXXXXXXXXXXXXXXXXXXXXXXXXXXXX
X--------------------------------------X
X--------------------------------------X
X--------------------------------------X
X--------------------------------------X
XXXXXXXXXXXXXXXXXXXXXXXXXXXXXXX--------X
X--------------------------------------X
X--------------------------------------X
X--------------------------------------X
X--------------------------------------XX--------------------------------------XX--------------------------------------XX----------------------------------------------------------------------------------------------------------------------X
X----XXXXXXXXXXXXXXXXXXXXXXXXXXXXXXXXXXXXXXXXXXXXXXXXXXXXXXXXXXXXXXXXXXXXXXXXXXXXXXXXXXXXXXXXXXXXXXXXXXXXXXXXXXXXXXXXXXXX----XXXXXXXXXXXXXXXXXXXXXXXXXXXXXXXXXXXXXXXXXXXXXXXXXXXXXXXXXXXXXXXXXXXXXXXXXXXXXXXXXXXXXXXXXXXXXXXXXXXXXXXXXXXXXXXXXXX
X----------------------------------------------------------------------------------------------------------------------X
X-------------------------------------------------------------------------------------------------------------------O--X
X--------------------------------------XX----------------------------------------------------------------------------------------------------------------------XX------------------------------------------------------------------------------X
X--------------------------------------XX----------------------------------------------------------------------------------------------------------------------XX------------------------------------------------------------------------------X
XXXXXXXXXXXXXXXXXXXXXXXXXXXXXXXXXXXXXXXXXXXXXXXXXXXXXXXXXXXXXXXXXXXXXXXXXXXXXXXXXXXXXXXXXXXXXXXXXXXXXXXXXXXXXXXXXXXXXXXXXXXXXXXXXXXXXXXXXXXXXXXXXXXXXXXXXXXXXXXXXXXXXXXXXXXXXXXXXXXXXXXXXXXXXXXXXXXXXXXXXXXXXXXXXXXXXXXXXXXXXXXXXXXXXXXXXXXXXXXX