XXXXXXXXXXXXXXXXXXXXXXXXXXXXXXXXXXXXXXXXXXXXXXXXXXXXXXXXXXXXXXXXXXXXXXXXXXXXXXXXXXXXX
X-----------------------------------------------------------------------------------X
X-O---------------------------------------------------------------------------------X
X-----------------------------------------------------------------------------------X
X-----------------------------------------------------------------------------------X
X-----------------------------------------------------------------------------------X
X-----------------------------------------------------------------------------------X
X-----------------------------------------------------------------------------------X
X-----------------------------------------------------------------------------------X
X-----------------------------------------------------------------------------------X
XXX---------------------------------------------------------------------------------X
X--X--------------------------------------------------------------------------------X
X---X-------------------------------------------------------------------------------X
X----X------------------------------------------------------------------------------X
X-----X-----------------------------------------------------------------------------X
X------X----------------------------------------------------------------------------X
X-------X---------------------------------------------------------------------------X
X--------X--------------------------------------------------------------------------X
X---------X-------------------------------------------------------------------------X
X----------X------------------------------------------------------------------------X
X-----------X-----------------------------------------------------------------------X
X------------X----------------------------------------------------------------------X
X-------------X--------X------X-----------------------------------------------------X
X--------------X-------X------X-----------------------------------------------------X
X---------------X------X------X-----------------------------------------------------X
X----------------X-----X------X----XXXXXXXXXXXXXXXXXXXXXXXXXXXXX--------------------X
X-----------------X----X------X--------------------------------X--------------------X
X------------------XXXXX------XXXXXXXXXXXXXXXXXXXXXXXXXXXXXXXXXXXXXXXXXXXXXXXXXXXXXXX
X-----------------------------------------------------------------------------------X
X-----------------------------------------------------------------------------------X
X-----------------------------------------------------------------------------------X
X-----------------------------------------------------------------------------------X
X-----------------------------------------------------------------------------------X
X-----------------------------------------------------------------------------------X
X-----------------------------------------------------------------------------------X
X-----------------------------------------------------------------------------------X
X-----------------------------------------------------------------------------------X
X-----------------------------------------------------------------------------------X
X-----------------------------------------------------------------------------------X
X-----------------------------------------------------------------------------------X
X-----------------------------------------------------------------------------------X
X-----------------------------------------------------------------------------------X
X-----------------------------------------------------------------------------------X
X-----------------------------------------------------------------------------------X
X-----------------------------------------------------------------------------------X
X-----------------------------------------------------------------------------------X
X-----------------------------------------------------------------------------------X
X-----------------------------------------------------------------------------------X
X-----------------------------------------------------------------------------------X
X-----------------------------------------------------------------------------------X
X-----------------------------------------------------------------------------------X
X-----------------------------------------------------------------------------------X
X-----------------------------------------------------------------------------------X
X-----------------------------------------------------------------------------------X
X-----------------------------------------------------------------------------------X
X-----------------------------------------------------------------------------------X
X-----------------------------------------------------------------------------------X
XFFFFFFFFFFFFFFFFFFFFFFX--------XFFFFFFFFFFFFFFFFFFFFFFFFFFFFFFFFFFFFFFFFFFFFFFFFFFXX
X-----------------------------------------------------------------------------------X
X-----------------------------------------------------------------------------------X
X-----------------------------------------------------------------------------------X
XXXXXXXXXXXXXXXXXXXXXXXXXXXXXXXXXXXXXXXXXXXXXXXXXXXXXXXXXXXXXXXXXXXXXXXXXXXXXXXXXXXXX