XXXXXXXXXXXXXXXXXXXXXXXXXXXXXXXXXXXXXXXXXXXXXXXXXXXXXXXXXXXXXXXXXXXXXXXXXXXXXXXXXXXXXXXXXXXXXXXXXXXXXXX
X----------------------------------------------------------------------------------------------------FX
X----------------------------------------------------------------------------------------------------FX
X----------------------------------------------------------------------------------------------------FX
X----------------------------------------------------------------------------------------------------FX
X----------------------------------------------------------------------------------------------------FX
X----------------------------------------------------------------------------------------------------FX
X----------------------------------------------------------------------------------------------------FX
X----------------------------------------------------------------------------------------------------FX
X----------------------------------------------------------------------------------------------------FX
X----------------------------------------------------------------------------------------------------FX
X----------------------------------------------------------------------------------------------------FX
X----------------------------------------------------------------------------------------------------FX
X---------------XXXXXXXXX----XXXX----XXXX----XXXX-----XXXX-----XXXX----XXXX----XXXX---XXXX----XXXXFFFFX
X--------------XX-------------------------------------------------------------------------------------X
X-------------XXXHHHHHHHHHHHHHHHHHHHHHHHHHHHHHHHHHHHHHHHHHHHHHHHHHHHHHHHHHHHHHHHHHHHHHHHHHHHHHHHHHHHHHX
X------------XXXXXXXXXXXXXXXXXXXXXXXXXXXXXXXXXXXXXXXXXXXXXXXXXXXXXXXXXXXXXXXXXXXXXXXXXXXXXXXXXXXXXXXXXX
X-----------------------------------------------------------------------------------------------------X
X-----------------------------------------------------------------------------------------------------X
X-----------------------------------------------------------------------------------------------------X
X-----------------------------------------------------------------------------------------------------X
X-----------------------------------------------------------------------------------------------------X
XXXXXXXXXXXXXXXXXXXXXXXXXXXXXXXXXXXXXXXXXXXXXXXXXXXXXXXXXXXXXXXXXXXXXXXXXXXXXXXXXXXXXXXXXXX-----------X
X-----------------------------------------------------------------------------------------------------X
X-----------------------------------------------------------------------------------------------------X
X-----------------------------------------------------------------------------------------------------X
X-----------------------------------------------------------------------------------------------------X
X-----------------------------------------------------------------------------------------------------X
X------------XXXXXXXXXXXXXXXXXXXXXXXXXXXXXXXXXXXXXXXXXXXXXXXXXXXXXXXXXXXXXXXXXXXXXXXXXXXXXXXXXXXXXXXXXX
X-----------------------------------------------------------------------------------------------------X
X-----------------------------------------------------------------------------------------------------X
X-----------------------------------------------------------------------------------------------------X
X-----------------------------------------------------------------------------------------------------X
X-----------------------------------------------------------------------------------------------------X
XXXXXXXXXXXXXXXXXXXXXXXXXXXXXXXXXXXXXXXXXXXXXXXXXXXXXXXXXXXXXXXXXXXXXXXXXXXXXXXXXXXXXXXXXXX-----------X
X-----------------------------------------------------------------------------------------------------X
X-----------------------------------------------------------------------------------------------------X
X--O-------------------------------------------------------------X------------------------------------X
X----------------------------------------------------------------X------------------------------------X
X----------------------------------------------------------------X------------------------------------X
XXXXXXXXXXXXXXXXXXXXXXXXXXXXXXXXXXXXXXXXXXXXXXXXXXXXXXXXXXXXXXXXXXXXXXXXXXXXXXXXXXXXXXXXXXXXXXXXXXXXXXX