XXXXXXXXXXXXXXXXXXXXXXXXXXXXXXXXXXXXXXXXXXXXXXXXXXXXXXXXXXXXXXXXXXXXXXXXXXXXXXXXXXXXXXXXXXXXXXXXXXXXXXXXXXXXXXXXXXXXXXXXXX
X------------------------------------------------------------------------------------------------------------------------X
X------------------------------------------------------------------------------------------------------------------------X
X----XXXXXXXXXXXXXXXXXXXXXXXXXXXXXXXXXXX---------------------------------------------------------------------------------X
X--------------------------------------X---------------------------------------------------------------------------------X
X--------------------------------------X---------------------------------------------------------------------------------X
XXXXXXXXXXXXXXXXXXXXX------------------X---------------------------------------------------------------------------------X
XXXXXXXXXXXXXXXXXXXXXXXXX-----------XXXXXXXXX----------------------------------------------------------------------------X
XXXXXXXXXXXXXXXXXXXXXXXXX--------XXXXXXX---------------------------------------------------------------------------------X
X--------------------------------------X---------------------------------------------------------------------------------X
X--------------------------------------X---------------------------------------------------------------------------------X
X--------------------------------------X---------------------------------------------------------------------------------X
X--------------------------------------X-------XXXXX---------------------------------------------------------------------X
X--------------------------XXXX--------X---------------------------------------------------------------------------------X
X--------------------------------------X---------------------------------------------------------------------------------X
X--------------------------------------X---------------------------------------------------------------------------------X
X--------------------------------------X-----------------------------------------------------X----XX--X------------------X
X----XXXXXXXXXXXXXXXXXXXXXXXXXXXXXXXXXXX----------XXXXX--------------------------------------X---X--X-X------------------X
X--------------------------------------X-----------------------------------------------------XXX--XX--XXX----------------X
X--------------------------------------X---------------------------------------------------------------------------------X
X--------------------------------------X---------------------------------------------------------------------------------X
X--------------------------------------X-------------XXXXX---------------------------------------------------------------X
XXXXXXXXXXXXXXXXXXXXXXXXXXXXXXX--------X-----------------------------XXXXX-----------------------------------------------X
X--------------------------------------X---------------------------------------------------------------------------------X
X--------------------------------------X---------------------------------------XXXXX---------XXXXXXXXXXXXXXXXXXXXXXXXXXXXX
X--------------------------------------X---------------------------------------XXXXX-------------------------------------X
X--------------------------------------XXHHHHHHHHHHHHHHHHHHHHHH-------HHHHHHHHHXXXXX-------------------------------------X
X----XXXXXXXXXXXXXXXXXXXXXXXXXXXXXXXXXXXXXXXXXXXXXXXXXXXXXXXXXXXXXXXXXXXXXXXXXXXXXXXXXXXXXXXXXXXXXX---XXXXXXXXXXXXXXXXXXXXXXXXXXXXXXXXXXXXXXXXXXXXXXXXXXXXXXXXXXXXXXXXXXXXXXXXXXXXXXXXXXXXXXXXXXXXXXXXXXXXXXXXXXXXXXXXXXXXXXXXXXXXXXXXXXXXXXXXXX
X--------------------------------------------------------------------------------------------FFXXXX--------------------XX----------------------------------------------------------------------------------------------------------------------X
X--------------------------------------------------------------------------------------------FFXXXX--------------------XX--------------------------------------------------------------------------------------------------------------O-------X
X--------------------------------------XX----------------------------------------------------FFXXXX--------------------------------XXXX--------------------------------------------------------------------------------------------------------X
X--------------------------------------XX----------------------------------------------------FFXXXX--------------------------------XXXX------------------------XX----------------------------------------X-------------------------------------X
XXXXXXXXXXXXXXXXXXXXXXXXXXXXXXXXXXXXXXXXXXXXXXXXXXXXXXXXXXXXXXXXXXXXXXXXXXXXXXXXXXXXXXXXXXXXXXXXXXXXXXXXXXXXXXXXXXXXXXXXXXXXXXXXXXXXXXXXXXXXXXXXXXXXXXXXXXXXXXXXXXXXXXXXXXXXXXXXXXXXXXXXXXXXXXXXXXXXXXXXXXXXXXXXXXXXXXXXXXXXXXXXXXXXXXXXXXXXXXXX