XXXXXXXXXXXXXXXXXXXXXXXXXXXXXXXXXXXXXXXXXXXXXXXXXXXXXXXXXXXXXXXXXXXXXXXXXXXXXXXXXXXXX
X-----------------------------------------------------------------------------------X
X-O---------------------------------------------------------------------------------X
X-----------------------------------------------------------------------------------X
X-----------------------------------------------------------------------------------X
X-----------------------------------------------------------------------------------X
X-----------------------------------------------------------------------------------X
X-----------------------------------------------------------------------------------X
X-----------------------------------------------------------------------------------X
X-----------------------------------------------------------------------------------X
X-X-------XXXXXXXXXXXXXXXXXXXXXX----------------------------------------------------X
X--X-------X------------------------------------------------------------------------X
X---X-------X-----------------------------------------------------------------------X
X----X-------X------X-------XXXXXXX-------------------------------------------------X
X-----X-------X------X-------X----X-------------------------------------------------X
X---XXXX-------X------X-------XXXXX-------------------------------------------------X
X------XX-------X------X------------------------------------------------------------X
X------X-X-------X------X-----------------------------------------------------------X
X------X--X-------X------XXXXXXXXXX-------------------------------------------------X
XXXX---X---X-------X----------------------------------------------------------------X
X------X----X-------X---------------------------------------------------------------X
X------X-----X-------X--------------------------------------------------------------X
X------X------X--------X------X-----------------------------------------------------X
X------X-------X-------X------X-----------------------------------------------------X
X--XXXXX--------X------X------X-----------------------------------------------------X
X------X---------X-----X------X----XXXXXXXXXXXXXXXXXXXXXXXXXXXXX--------------------X
X------X----------X----X------X--------------------------------X--------------------X
X------X-----------X---X------XXXXXXXXXXXXXXXXXXXXXXXXXXXXXXXXXXXXXXXXXXXXXXXXXXXXXXX
XXX----X---------------X------------------------------------------------------------X
X------X---------------X------------------------------------------------------------X
X------X-XXXXXXXXXXXXXXXXXXXXXXXXXXXXXXXXXXXXXXXXXXXXXXXXXXXXXXXXXX--------X--------X
X------X----------------------------------------------------------X--------X--------X
X----XXX----------------------------------------------------------XXX---XXXX--------X
X------X-------------------------------------------------------------------X--------X
X------X-------------------------------------------------------------------X--------X
X------X-------------------------------------------------------------------X--------X
XXX----X-------------------------------------------------------------------X--------X
X--------------------------------------------------------------------------X--------X
X--------------------------------------------------------------------------X--------X
X--------------------------------------------------------------------------X--------X
XXXXXXXXXXXXXXXXXXXXXXXXXXXXXXXXXXXXXXXXXXXXXXXXXXXXXXXXXXXXXXXXXXXXXXXXXXXX--------X
X-----------------------------------------------------------------------------------X
X-----------------------------------------------------------------------------------X
X-----------------------------------------------------------------------------------X
X-----------------------------------------------------------------------------------X
X-----------------------------------------------------------------------------------X
X-----------------------------------------------------------------------------------X
X-----------------------------------------------------------------------------------X
X-----------------------------------------------------------------------------------X
X-----------------------------------------------------------------------------------X
X-----------------------------------------------------------------------------------X
X-----------------------------------------------------------------------------------X
X-----------------------------------------------------------------------------------X
X-----------------------------------------------------------------------------------X
X-----------------------------------------------------------------------------------X
X-----------------------------------------------------------------------------------X
X-----------------------------------------------------------------------------------X
XFFFFFFFFFFFFFFFFFFFFFFFFFFFFFFFFFFFFFFFFFFFFFFFFFFFFFFFFFFFFFFFFFFFFFFFFFFFFFFFFFFFX
X-----------------------------------------------------------------------------------X
X-----------------------------------------------------------------------------------X
X-----------------------------------------------------------------------------------X
XXXXXXXXXXXXXXXXXXXXXXXXXXXXXXXXXXXXXXXXXXXXXXXXXXXXXXXXXXXXXXXXXXXXXXXXXXXXXXXXXXXXX